xxxxxxxxxxx
xVVVVVVVVVx
xVB=S====Vx
xV==V====Vx
xV==V====Vx
xVVVV====Vx
xV=======Vx
xV=======Vx
xVV=====VVx
xxVVVTVVVxx
xxxxx=xxxxx